NO /home/hahamdan/github_project/cub3d/assets/north.png
SO /home/hahamdan/github_project/cub3d/assets/south.png
WE /home/hahamdan/github_project/cub3d/assets/west.png
EA /home/hahamdan/github_project/cub3d/assets/east.png
F 184,113,39
C 51,198,227

        1111111111111111111111111
        110000000011000000011111
        1000000001110000010110001
        1001000000000000000110001
111111111011000001110000000000001
110000000011000001110111111111111
11110111111111011100000010001
11110111111111011111010010001
11000000110101011100000011001
11001000100000001100000000001
11000000000100001101010010001
11000001110101011111111110N0111
11110111 1111101 101111010001
11111111 1111111 111111111111
