NO /home/mbyrne/Cub3d/assets/ground.png
SO /home/mbyrne/Cub3d/assets/south.png
WE /home/mbyrne/Cub3d/assets/west.png
EA /home/mbyrne/Cub3d/assets/ocean.png
F 0,0,0
C 255,255,255

1111111111111111111111111
110000000011000000011111
1000000001110000010110001
1001000000000000000110001
10000000S0110000000000001
1011000001110000000000001
1001000000000000000000001
1111111111111111111111111